Level_2.txt
10 10
++++++++++
+........+
+......#.+
+........+
+........+
+.*......+
+.....++++
+.....+...
+W....+...
+++++++...
0
0
