level 3
15 15
++++++++++++++
+...#........+
+............+
+............+
+......#.....+
+............+
+............+
+W.....+++++++
+......+++++++
+......+++++++
+......+++++++
+............+
+...*........+
+........*...+
++++++++++++++